Road To Foxborough
An Interactive Fiction by Avery Serna
Release 1 / Serial number 170301 / Inform 7 build 6M62 (I6/v6.33 lib 6/12N) SD

Outside
Congratulations! You were the #1 overall pick in the draft to the New England Patriots! You survived training camp and were signed to a 5 year $100,000,000 contract. You are the future of this franchise.

Just ahead of you is the Gillette Stadium. The new season starts today so get to the locker room and prepare yourself for tonight's game against the Falcons. Good Luck!.

>North
Hallway
You walk into a hallway. Straight ahead is a graphic of the phrase DO YOUR JOB! plastered on the wall. The hallway continues to the East and West.

>East
East Hallway
The East Hall is full of framed pictures of past and present Patriots. To the north is a door leading to the Locker Room.

>North
Southeast Locker Room
Huge floor to ceiling open style, oak lockers line the perimeter of the room. The room is nearly divide into fourths by the same lockers, there are laundry carts scattered throughout the room and there is a huge space in the middle with the Patriots Logo. Exits are to the south, east, north, and west.

It's Malcom Butler!

What's up Rookie. Excited? I was too before my first game. You should go get suited up over in the receiver corner.

>n
Northeast Locker Room
Huge floor to ceiling open style, oak lockers line the perimeter of the room. The room is nearly divide into fourths by the same lockers, there are laundry carts scattered throughout the room and there is a huge space in the middle with the Patriots Logo. On the north wall next to the tunnel is large whiteboard with writing on it. Exits are to the east, west, north, and south.

Woah it's Rob Gronkowski.

Hey Bro! Let's get this win today and PARTAY!!

>n
Tunnel
A long dimly lit tunnel. A bright light shines at the end of it... Gillette Stadium.

Coach Bill is standing in the darkness of the tunnel, wearing the same Patriots hoodie with the cut off sleeves. He is giving inspiring words to the players running by him.

Come back when your're game ready, kid

>n
Gillette Stadium
The empty stadium is near dead silent pre-game. The only people around are a few Patiot grounds keepers and security guards. North of your position now, across the field is the tunnel leading to the Falcon's locker room.

* * *

Road To Foxborough
An Interactive Fiction by Avery Serna
Release 1 / Serial number 170301 / Inform 7 build 6M62 (I6/v6.33 lib 6/12N) SD

Outside
Congratulations! You were the #1 overall pick in the draft to the New England Patriots! You survived training camp and were signed to a 5 year $100,000,000 contract. You are the future of this franchise.

Just ahead of you is the Gillette Stadium. The new season starts today so get to the locker room and prepare yourself for tonight's game against the Falcons. Good Luck!.

>n
Hallway
You walk into a hallway. Straight ahead is a graphic of the phrase DO YOUR JOB! plastered on the wall. The hallway continues to the East and West.

>e
East Hallway
The East Hall is full of framed pictures of past and present Patriots. To the north is a door leading to the Locker Room.

>n
Southeast Locker Room
Lockers line the perimeter of the room. The room is nearly divided into fourths by the same kind of lockers, there are laundry carts scattered throughout the room and there is a huge space in the middle with the Patriots Logo. Exits are to the south, east, north, and west.

It's Malcom Butler!

What's up Rookie. Excited? I was too before my first game. You should go get suited up over in the receiver corner.

You can also see Lockers here.

>e
Equipment Room 1
Rows of floor to ceiling shelves lined with HELMETS & SHOULDER PADS all ranging in sizes. Exits are to the west and north.

Mark, the equipment manager, is taking count of the helmets over in the corner.

He sees you in the doorway.

You must be here for your helmet and shoulder pads. Just a heads up your helmet needs some tweaking. You can fix it with a SCREWDRIVER but I have no idea where it is. Tom Brady the quarterback was the last to use it. Find the screwdriver and I'll have a working helmet for you.

You can also see Shoulder pads here.

>x helmets
The all silver helmet glistens in the light. The Patriots logo  is plastered on the sides with a red facemask.

>x helmet
You can't see any such thing.

>w
Southeast Locker Room
Lockers line the perimeter of the room. The room is nearly divided into fourths by the same kind of lockers, there are laundry carts scattered throughout the room and there is a huge space in the middle with the Patriots Logo. Exits are to the south, east, north, and west.

It's Malcom Butler!

What's up Rookie. Excited? I was too before my first game. You should go get suited up over in the receiver corner.

You can also see Lockers here.

>w
Southwest Locker Room
Huge floor to ceiling open style, oak lockers line the perimeter of the room. The room is nearly divided into fourths by the same lockers, there is a huge space in the middle with the Patriots Logo. Exits are to the south, west, north and east.

It's Dont'a Hightower!

Hey rook, don't be late for warmups. Get to the receiver corner, Juls wanted to talk to you before you head out.

>w
Conference Room
An enormous lecture hall type of room. The team gathers here the week of the game to watch film of the opposing team. Exits are to the east and north

>n
Quarterback Room
A smaller office like room. One table in the center of the room with office chairs all around it. At the front of the room is a large screen and a projector hanging over the table. On the table is the missing screwdriver. Exits are to the east and south.

You can see screen and Screwdriver here.

>take screwdriver
Mark the equipment manager appears. Thanks for finding the screwdriver kid, enjoy your helmet and good luck!"

>w
You can't go that way.

>e
Northwest Locker Room
Huge floor to ceiling open style, oak lockers line the perimeter of the room. The room is nearly divided into fourths by the same lockers, there is a huge space in the middle with the Patriots Logo. Exits are to the south, west, east, and north.

Julian Edelman has appeared!!

Welcome to the receiver corner! Here, take these new gloves as a welcoming present.

This is your locker. You'll find most of your things in here, otherwise, try checking the equipment rooms. One more thing... We really need you today. Anything to win ... anything.

You can also see Gloves, Jersey and Game pants here.

>w
Quarterback Room
A smaller office like room. One table in the center of the room with office chairs all around it. At the front of the room is a large screen and a projector hanging over the table. On the table is the missing screwdriver. Exits are to the east and south.

You can see Game Helmet and screen here.

* * *

>n
Southeast Locker Room
Lockers line the perimeter of the room. The room is nearly divided into fourths by the same kind of lockers, there are laundry carts scattered throughout the room and there is a huge space in the middle with the Patriots Logo. Exits are to the south, east, north, and west.

It's Malcom Butler!

What's up Rookie. Excited? I was too before my first game. You should go get suited up over in the receiver corner.

You can also see Lockers here.

>s
East Hallway
The East Hall is full of framed pictures of past and present Patriots. To the north is a door leading to the Locker Room.

You can see Pictures here.

>x pictures
Here's a picture of Tom Brady mid drop. And here's Randy Moss and his one handed catch against the Jets. Over there is one of Rob Gronkowski doing his signature spike.

>n
Southeast Locker Room
Huge floor to ceiling open style, oak lockers line the perimeter of the room. The room is nearly divide into fourths by the same lockers, there are laundry carts scattered throughout the room and there is a huge space in the middle with the Patriots Logo.

It's Malcom Butler!

What's up Rookie. Excited? I was too before my first game. You should go get suited up over in the receiver corner.

>w
You can't go that way.

>e
Equipment Room 1

>n
You can't go that way.

>s
You can't go that way.

>e
You can't go that way.

>n
You can't go that way.

>w
Southeast Locker Room
Huge floor to ceiling open style, oak lockers line the perimeter of the room. The room is nearly divide into fourths by the same lockers, there are laundry carts scattered throughout the room and there is a huge space in the middle with the Patriots Logo.

It's Malcom Butler!

What's up Rookie. Excited? I was too before my first game. You should go get suited up over in the receiver corner.

>s
East Hallway
The East Hall is full of framed pictures of past and present Patriots. To the north is a door leading to the Locker Room.

You can see Pictures here.

>n
Southeast Locker Room
Huge floor to ceiling open style, oak lockers line the perimeter of the room. The room is nearly divide into fourths by the same lockers, there are laundry carts scattered throughout the room and there is a huge space in the middle with the Patriots Logo.

It's Malcom Butler!

What's up Rookie. Excited? I was too before my first game. You should go get suited up over in the receiver corner.

* * *

>e
Equipment Room 1

>w
Southeast Locker Room
Huge floor to ceiling open style, oak lockers line the perimeter of the room. The room is nearly divide into fourths by the same lockers, there are laundry carts scattered throughout the room and there is a huge space in the middle with the Patriots Logo.

It's Malcom Butler!

What's up Rookie. Excited? I was too before my first game. You should go get suited up over in the receiver corner.

* * *

>s
East Hallway
The East Hall is full of framed pictures of past and present Patriots. To the north is a door leading to the Locker Room.

You can see Pictures here.

>s
You can't go that way.

>n
Southeast Locker Room
Huge floor to ceiling open style, oak lockers line the perimeter of the room. The room is nearly divide into fourths by the same lockers, there are laundry carts scattered throughout the room and there is a huge space in the middle with the Patriots Logo.

It's Malcom Butler!

What's up Rookie. Excited? I was too before my first game. You should go get suited up over in the receiver corner.

>s
East Hallway
The East Hall is full of framed pictures of past and present Patriots. To the north is a door leading to the Locker Room.

You can see Pictures here.

>e
You can't go that way.

>w
Hallway
You walk into a hallway. Straight ahead is a graphic of the phrase DO YOUR JOB! plastered on the wall. The hallway continues to the East and West.

>w
West Hallway
The West Hall, very similar ot the east, is also covered in photos of Patriots and newspaper headlines. To the north is the locker room.

You can see Photos and Newspapers here.

>x photos
Here is a photo of Deion Branch in Super Bowl 39. And there's one of Adam Vinatieri and his game winning kick in Super Bowl 36.

>x newspaper
All of the newspaper headlines from the Patriots Super Bowl wins are here. From 2002, 2004, 2005, 2015, and 2017.

>n
Southwest Locker Room
Huge floor to ceiling open style, oak lockers line the perimeter of the room. The room is nearly divide into fourths by the same lockers, there are laundry carts scattered throughout the room and there is a huge space in the middle with the Patriots Logo.

It's Dont'a Hightower!

Hey rook, don't be late for warmups. Get to the receiver corner, Juls wanted to talk to you before you head out.

>x logo
You can't see any such thing.

>n
Northwest Locker Room
Huge floor to ceiling open style, oak lockers line the perimeter of the room. The room is nearly divide into fourths by the same lockers, there are laundry carts scattered throughout the room and there is a huge space in the middle with the Patriots Logo.

Julian Edelman has appeared!!

Hey kid come here a sec. Welcome to the receiver corner! Here's your locker. You'll find most of your things in here, otherwise try checking the equipment rooms. One more thing... We really need you today. Anything to win ... anything.

>i
You are carrying nothing.

>talk to julian edelman
I didn't understand that sentence.

>n
Tunnel
Coach Bill is standing in the darkness of the tunnel, wearing the same Patriots hoodie with the cut off sleeves. He is giving inspiring words to the players running by him.

>x coach bill
You can't see any such thing.

>w
You can't go that way.

>e
You can't go that way.

>n
Gillette Stadium

>n
Falcon's Tunnel

>n
Falcon Locker Room

>x locker room
You can't see any such thing.

>n
You can't go that way.

>w
You can't go that way.

* * *

>e
You can't go that way.

>s
Falcon's Tunnel

>s
Gillette Stadium

>w
You can't go that way.

* * *

>e
You can't go that way.

>s
Tunnel
Coach Bill is standing in the darkness of the tunnel, wearing the same Patriots hoodie with the cut off sleeves. He is giving inspiring words to the players running by him.

>s
Northwest Locker Room
Huge floor to ceiling open style, oak lockers line the perimeter of the room. The room is nearly divide into fourths by the same lockers, there are laundry carts scattered throughout the room and there is a huge space in the middle with the Patriots Logo.

Julian Edelman has appeared!!

Hey kid come here a sec. Welcome to the receiver corner! Here's your locker. You'll find most of your things in here, otherwise try checking the equipment rooms. One more thing... We really need you today. Anything to win ... anything.

>s
Southwest Locker Room
Huge floor to ceiling open style, oak lockers line the perimeter of the room. The room is nearly divide into fourths by the same lockers, there are laundry carts scattered throughout the room and there is a huge space in the middle with the Patriots Logo.

It's Dont'a Hightower!

Hey rook, don't be late for warmups. Get to the receiver corner, Juls wanted to talk to you before you head out.

>s
West Hallway
The West Hall, very similar ot the east, is also covered in photos of Patriots and newspaper headlines. To the north is the locker room.

You can see Photos and Newspapers here.

>s
You can't go that way.

>e
Hallway
You walk into a hallway. Straight ahead is a graphic of the phrase DO YOUR JOB! plastered on the wall. The hallway continues to the East and West.

>e
East Hallway
The East Hall is full of framed pictures of past and present Patriots. To the north is a door leading to the Locker Room.

You can see Pictures here.

>e
You can't go that way.

>n
Southeast Locker Room
Huge floor to ceiling open style, oak lockers line the perimeter of the room. The room is nearly divide into fourths by the same lockers, there are laundry carts scattered throughout the room and there is a huge space in the middle with the Patriots Logo.

It's Malcom Butler!

What's up Rookie. Excited? I was too before my first game. You should go get suited up over in the receiver corner.

* * *

>e
Equipment Room 1

>x room
You can't see any such thing.

>w
Southeast Locker Room
Huge floor to ceiling open style, oak lockers line the perimeter of the room. The room is nearly divide into fourths by the same lockers, there are laundry carts scattered throughout the room and there is a huge space in the middle with the Patriots Logo.

It's Malcom Butler!

What's up Rookie. Excited? I was too before my first game. You should go get suited up over in the receiver corner.

>w
You can't go that way.

>n
Northeast Locker Room
Huge floor to ceiling open style, oak lockers line the perimeter of the room. The room is nearly divide into fourths by the same lockers, there are laundry carts scattered throughout the room and there is a huge space in the middle with the Patriots Logo.

Woah it's Rob Gronkowski.

Hey Bro! Let's get this win today and PARTAY!!

* * *

>e
East Hallway
The East Hall is full of framed pictures of past and present Patriots. To the north is a door leading to the Locker Room.

>x pictures
Here's a picture of Tom Brady mid drop. And here's Randy Moss and his one handed catch against the Jets. Over there is one of Rob Gronkowski doing his signature spike.

>n
Southeast Locker Room
Lockers line the perimeter of the room. The room is nearly divided into fourths by the same kind of lockers, there are laundry carts scattered throughout the room and there is a huge space in the middle with the Patriots Logo. Exits are to the south, east, north, and west.

It's Malcom Butler!

What's up Rookie. Excited? I was too before my first game. You should go get suited up over in the receiver corner.

You can also see Lockers here.

>talk to malcom butler
I didn't understand that sentence.

>e
Equipment Room 1
Rows of floor to ceiling shelves lined with HELMETS & SHOULDER PADS all ranging in sizes. Exits are to the west and north.

Mark, the equipment manager, is taking count of the helmets over in the corner.

He sees you in the doorway.

You must be here for your helmet and shoulder pads. Just a heads up your helmet needs some tweaking. You can fix it with a SCREWDRIVER but I have no idea where it is. Tom Brady the quarterback was the last to use it. Find the screwdriver and I'll have a working helmet for you.

You can also see Shoulder pads here.

>x helmet
The all silver helmet glistens in the light. The Patriots logo  is plastered on the sides with a red facemask.

>x helmets
You can't see any such thing.

>x shoulder pads
Lightweight small shoulder pads with mesh padding lining the inside.

>take shoulder pads
Taken.

>take helmet
That's hardly portable.

>talk to mark
I didn't understand that sentence.

>n
You can't go that way.

>w
Southeast Locker Room
Lockers line the perimeter of the room. The room is nearly divided into fourths by the same kind of lockers, there are laundry carts scattered throughout the room and there is a huge space in the middle with the Patriots Logo. Exits are to the south, east, north, and west.

It's Malcom Butler!

What's up Rookie. Excited? I was too before my first game. You should go get suited up over in the receiver corner.

You can also see Lockers here.

>x lockers
Huge floor to ceiling open style, oak lockers. Some still have jerseys hanging in them, others have the team's casual clothes inside.

>x laundry carts
These carts are used to move the team's dirty laundry. They are empty now, ready to be used after the game, but you can still smell yesterday's practice uniforms coming from the cart.

>x logo
You can't see any such thing.

>w
You can't go that way.

>e
Equipment Room 1
Rows of floor to ceiling shelves lined with HELMETS & SHOULDER PADS all ranging in sizes. Exits are to the west and north.

Mark, the equipment manager, is taking count of the helmets over in the corner.

He sees you in the doorway.

You must be here for your helmet and shoulder pads. Just a heads up your helmet needs some tweaking. You can fix it with a SCREWDRIVER but I have no idea where it is. Tom Brady the quarterback was the last to use it. Find the screwdriver and I'll have a working helmet for you.

>w
Southeast Locker Room
Lockers line the perimeter of the room. The room is nearly divided into fourths by the same kind of lockers, there are laundry carts scattered throughout the room and there is a huge space in the middle with the Patriots Logo. Exits are to the south, east, north, and west.

It's Malcom Butler!

What's up Rookie. Excited? I was too before my first game. You should go get suited up over in the receiver corner.

You can also see Lockers here.

>w
You can't go that way.

>n
Northeast Locker Room
Huge floor to ceiling open style, oak lockers line the perimeter of the room. The room is nearly divided into fourths by the same lockers, there is a huge space in the middle with the Patriots Logo. On the north wall next to the tunnel is large whiteboard with writing on it. Exits are to the east, west, north, and south.

Woah it's Rob Gronkowski.

Hey Bro! Let's get this win today and PARTAY!!

>w
You can't go that way.

>x whiteboard
Just a normal whiteboard. It reads:

Are you game ready? Things needed for tonight: - Jersey - Game pants - Helmet - Shoulder pads - Shoes - Gloves

>i
You are carrying:
  Shoulder pads

>x me
As good-looking as ever.

>n
Tunnel
A long dimly lit tunnel. A bright light shines at the end of it... Gillette Stadium.

Coach Bill is standing in the darkness of the tunnel, wearing the same Patriots hoodie with the cut off sleeves. He is giving inspiring words to the players running by him.

Come talk to me when you're game ready, kid

>talk to coach bill
I didn't understand that sentence.

>e
You can't go that way.

Come talk to me when you're game ready, kid

>w
You can't go that way.

Come talk to me when you're game ready, kid

>s
Northwest Locker Room
Huge floor to ceiling open style, oak lockers line the perimeter of the room. The room is nearly divided into fourths by the same lockers, there is a huge space in the middle with the Patriots Logo. Exits are to the south, west, east, and north.

Julian Edelman has appeared!!

Welcome to the receiver corner! Here, take these new glvoes as a welcoming present.

This is your locker. You'll find most of your things in here, otherwise, try checking the equipment rooms. One more thing... We really need you today. Anything to win ... anything.

You can also see Gloves, Jersey and Game pants here.

>i
You are carrying:
  Shoulder pads

>take gloves
Taken.

>x jersey
Navy blue home jerseys. White numbers with a grey and red trim.

>take jersey
Taken.

>x game pants
Light grey game pants with a white, red, and navy blue pinstripe down both legs.

>take game pants
Taken.

>x locker
A tall oak locker, just like all the others. Your name is printed at the top in a little name plate.

Inside you find your gloves from Juls, jersey and game pants

>s
Southwest Locker Room
Huge floor to ceiling open style, oak lockers line the perimeter of the room. The room is nearly divided into fourths by the same lockers, there is a huge space in the middle with the Patriots Logo. Exits are to the south, west, north and east.

It's Dont'a Hightower!

Hey rook, don't be late for warmups. Get to the receiver corner, Juls wanted to talk to you before you head out.

>e
You can't go that way.

>w
Conference Room
An enormous lecture hall type of room. The team gathers here the week of the game to watch film of the opposing team. Exits are to the east and north

>n
You can't go that way.

>e
Southwest Locker Room
Huge floor to ceiling open style, oak lockers line the perimeter of the room. The room is nearly divided into fourths by the same lockers, there is a huge space in the middle with the Patriots Logo. Exits are to the south, west, north and east.

It's Dont'a Hightower!

Hey rook, don't be late for warmups. Get to the receiver corner, Juls wanted to talk to you before you head out.

>s
West Hallway
The West Hall, very similar ot the east, is also covered in photos of Patriots and newspaper headlines. To the north is the locker room.

You can see Newspapers here.

>x newspapers
All of the newspaper headlines from the Patriots Super Bowl wins are here. From 2002, 2004, 2005, 2015, and 2017.

>take newspapers
Taken.

>e
Hallway
You walk into a hallway. Straight ahead is a graphic of the phrase DO YOUR JOB! plastered on the wall. The hallway continues to the East and West.

>e
East Hallway
The East Hall is full of framed pictures of past and present Patriots. To the north is a door leading to the Locker Room.

* * *

>n
Southeast Locker Room
Lockers line the perimeter of the room. The room is nearly divided into fourths by the same kind of lockers, there are laundry carts scattered throughout the room and there is a huge space in the middle with the Patriots Logo. Exits are to the south, east, north, and west.

It's Malcom Butler!

What's up Rookie. Excited? I was too before my first game. You should go get suited up over in the receiver corner.

You can also see Lockers here.

>e
Equipment Room 1
Rows of floor to ceiling shelves lined with HELMETS & SHOULDER PADS all ranging in sizes. Exits are to the west and north.

Mark, the equipment manager, is taking count of the helmets over in the corner.

He sees you in the doorway.

You must be here for your helmet and shoulder pads. Just a heads up your helmet needs some tweaking. You can fix it with a SCREWDRIVER but I have no idea where it is. Tom Brady the quarterback was the last to use it. Find the screwdriver and I'll have a working helmet for you.

* * *

>w
Southeast Locker Room
Lockers line the perimeter of the room. The room is nearly divided into fourths by the same kind of lockers, there are laundry carts scattered throughout the room and there is a huge space in the middle with the Patriots Logo. Exits are to the south, east, north, and west.

It's Malcom Butler!

What's up Rookie. Excited? I was too before my first game. You should go get suited up over in the receiver corner.

You can also see Lockers here.

>n
Northeast Locker Room
Huge floor to ceiling open style, oak lockers line the perimeter of the room. The room is nearly divided into fourths by the same lockers, there is a huge space in the middle with the Patriots Logo. On the north wall next to the tunnel is large whiteboard with writing on it. Exits are to the east, west, north, and south.

Woah it's Rob Gronkowski.

Hey Bro! Let's get this win today and PARTAY!!

>e
Equipment Room 2
Rows of floor to ceiling shelves full of shoes. Hundreds of pairs for the team, all different colors for home and away games. Exits are to the west and south.

You can see Shoes here.

>take shoes
Taken.

>w
Northeast Locker Room
Huge floor to ceiling open style, oak lockers line the perimeter of the room. The room is nearly divide into fourths by the same lockers, there are laundry carts scattered throughout the room and there is a huge space in the middle with the Patriots Logo. On the north wall next to the tunnel is large whiteboard with writing on it. Exits are to the east, west, north, and south.

Woah it's Rob Gronkowski.

Hey Bro! Let's get this win today and PARTAY!!

>s
Southeast Locker Room
Huge floor to ceiling open style, oak lockers line the perimeter of the room. The room is nearly divide into fourths by the same lockers, there are laundry carts scattered throughout the room and there is a huge space in the middle with the Patriots Logo. Exits are to the south, east, north, and west.

It's Malcom Butler!

What's up Rookie. Excited? I was too before my first game. You should go get suited up over in the receiver corner.

>s
East Hallway
The East Hall is full of framed pictures of past and present Patriots. To the north is a door leading to the Locker Room.

>w
Hallway
You walk into a hallway. Straight ahead is a graphic of the phrase DO YOUR JOB! plastered on the wall. The hallway continues to the East and West.

>w
West Hallway
The West Hall, very similar ot the east, is also covered in photos of Patriots and newspaper headlines. To the north is the locker room.

>n
Southwest Locker Room
Huge floor to ceiling open style, oak lockers line the perimeter of the room. The room is nearly divide into fourths by the same lockers, there are laundry carts scattered throughout the room and there is a huge space in the middle with the Patriots Logo. Exits are to the south, west, north and east.

It's Dont'a Hightower!

Hey rook, don't be late for warmups. Get to the receiver corner, Juls wanted to talk to you before you head out.

>n
Northwest Locker Room
Huge floor to ceiling open style, oak lockers line the perimeter of the room. The room is nearly divide into fourths by the same lockers, there are laundry carts scattered throughout the room and there is a huge space in the middle with the Patriots Logo. Exits are to the south, west, east, and north.

Julian Edelman has appeared!!

Welcome to the receiver corner! Here, take these new glvoes as a welcoming present.

This is your locker. You'll find most of your things in here, otherwise, try checking the equipment rooms. One more thing... We really need you today. Anything to win ... anything.

>w
Quarterback Room
A smaller office like room. One table in the center of the room with office chairs all around it. At the front of the room is a large screen and a projector hanging over the table. On the table is the missing screwdriver. Exits are to the east and south.

You can see screen and Screwdriver here.

>take screwdriver
Mark the equipment manager appears. Thanks for finding the screwdriver kid, enjoy you helmet and good luck!"

>x screen
just a plain screen used for projecting things on

>take screen
That's fixed in place.

>x chairs
You can't see any such thing.

>fix helmet
That's not a verb I recognise.

>i
You are carrying:
  Shoes
  Newspapers
  Game pants
  Jersey
  Gloves
  Shoulder pads

>take helmet
Taken.

>i
You are carrying:
  Helmet
  Shoes
  Newspapers
  Game pants
  Jersey
  Gloves
  Shoulder pads

>e
Northwest Locker Room
Huge floor to ceiling open style, oak lockers line the perimeter of the room. The room is nearly divide into fourths by the same lockers, there are laundry carts scattered throughout the room and there is a huge space in the middle with the Patriots Logo. Exits are to the south, west, east, and north.

Julian Edelman has appeared!!

Welcome to the receiver corner! Here, take these new glvoes as a welcoming present.

This is your locker. You'll find most of your things in here, otherwise, try checking the equipment rooms. One more thing... We really need you today. Anything to win ... anything.

>n
Tunnel
A long dimly lit tunnel. A bright light shines at the end of it... Gillette Stadium.

Coach Bill is standing in the darkness of the tunnel, wearing the same Patriots hoodie with the cut off sleeves. He is giving inspiring words to the players running by him.

Come talk to me when you're game ready, kid

>wear helmet
You put on Helmet.

Come talk to me when you're game ready, kid

>wear shoes
You put on Shoes.

Come talk to me when you're game ready, kid

>wear game pants
You put on Game pants.

Come talk to me when you're game ready, kid

>wear jersey
You put on Jersey.

Come talk to me when you're game ready, kid

>wear gloves
You put on Gloves.

Come talk to me when you're game ready, kid

>wear shoulder pads
You put on Shoulder pads.

Hey kid. I need a big favor of you. We really need this win today so I need you to sneak into the Falcon's locker room and steal their playbook. You can use the secret underground passage. The entrance is in the QB room, use the passcode "psi125" to gain entrance. Don't let us down

>s
Northwest Locker Room
Huge floor to ceiling open style, oak lockers line the perimeter of the room. The room is nearly divide into fourths by the same lockers, there are laundry carts scattered throughout the room and there is a huge space in the middle with the Patriots Logo. Exits are to the south, west, east, and north.

Julian Edelman has appeared!!

Welcome to the receiver corner! Here, take these new glvoes as a welcoming present.

This is your locker. You'll find most of your things in here, otherwise, try checking the equipment rooms. One more thing... We really need you today. Anything to win ... anything.

>w
Quarterback Room
A smaller office like room. One table in the center of the room with office chairs all around it. At the front of the room is a large screen and a projector hanging over the table. On the table is the missing screwdriver. Exits are to the east and south.

You can see screen here.

>x screen
just a plain screen used for projecting things on

>x projector
You can't see any such thing.

>x table
You can't see any such thing.

>n
(first opening screen)
It seems to be locked.

>psi125
You uttered the secret passcode. The large white screen swings open to reveal that it is acually a door. A metal door.

>n
(first opening Metal Door)

Underground Tunnel
A long tunnel, all rock and dirt, like it was just dug out of the ground. The tunnel is lit every 10 ft or so by old school torches on the wall. There is a faint light north of your position at the end of the tunnel.

You can see Metal Door here.

>x door
A Metal Door that appeared after you uttered the secret password.

>x torches
You can't see any such thing.

>x torch
You can't see any such thing.

>n
Falcon Locker Room
This locker room is used for the visiting teams. It's half the size of the Patriot's locker room. You hear the speakers in the stadium start to boom music. Pregame warmups just started. The room is empty. Lockers line the perimeter with a single table set up at the front of the room.

You can see Binder here.

>x binder
The cover of the binder bears the Falcon's Logo. You flip through the pages and find Xs and Os and route patterns strewn across the pages. This is it. The Falcon's Playbook.

>take binder
Taken.

    *** You did it! You stole the playbook. With this, the Patriots will be unstoppable this season.

Anything to win ***

Would you like to RESTART, RESTORE a saved game, QUIT or UNDO the last command?

* * *

>n
Southeast Locker Room
Lockers line the perimeter of the room. The room is nearly divided into fourths by the same kind of lockers, there are laundry carts scattered throughout the room and there is a huge space in the middle with the Patriots Logo. Exits are to the south, east, north, and west.

It's Malcom Butler!

What's up Rookie. Excited? I was too before my first game. You should go get suited up over in the receiver corner.

You can also see Lockers here.

>w
You can't go that way.

>s
East Hallway
The East Hall is full of framed pictures of past and present Patriots. To the north is a door leading to the Locker Room.

You can see Pictures here.

>w
Hallway
You walk into a hallway. Straight ahead is a graphic of the phrase DO YOUR JOB! plastered on the wall. The hallway continues to the East and West.

* * *

>x newspaper
All of the newspaper headlines from the Patriots Super Bowl wins are here. From 2002, 2004, 2005, 2015, and 2017.

>x newspapers
All of the newspaper headlines from the Patriots Super Bowl wins are here. From 2002, 2004, 2005, 2015, and 2017.

>n
Southwest Locker Room
Huge floor to ceiling open style, oak lockers line the perimeter of the room. The room is nearly divide into fourths by the same lockers, there are laundry carts scattered throughout the room and there is a huge space in the middle with the Patriots Logo.

It's Dont'a Hightower!

Hey rook, don't be late for warmups. Get to the receiver corner, Juls wanted to talk to you before you head out.

>n
Northwest Locker Room
Huge floor to ceiling open style, oak lockers line the perimeter of the room. The room is nearly divide into fourths by the same lockers, there are laundry carts scattered throughout the room and there is a huge space in the middle with the Patriots Logo.

Julian Edelman has appeared!!

Hey kid come here a sec. Welcome to the receiver corner! Here's your locker. You'll find most of your things in here, otherwise try checking the equipment rooms. One more thing... We really need you today. Anything to win ... anything.

* * *

>n
Hallway
You walk into a hallway. Straight ahead is a graphic of the phrase DO YOUR JOB! plastered on the wall. The hallway continues to the East and West.

>n
You can't go that way.

>enter door
You can't, since the door leads nowhere.

* * *

>n
You can't go that way.

>w
West Hallway
The West Hall, very similar ot the east, is also covered in photos of Patriots and newspaper headlines. To the north is the locker room.

You can see Newspapers here.

>n
Southwest Locker Room
Huge floor to ceiling open style, oak lockers line the perimeter of the room. The room is nearly divide into fourths by the same lockers, there are laundry carts scattered throughout the room and there is a huge space in the middle with the Patriots Logo.

It's Dont'a Hightower!

Hey rook, don't be late for warmups. Get to the receiver corner, Juls wanted to talk to you before you head out.

>n
Northwest Locker Room
Huge floor to ceiling open style, oak lockers line the perimeter of the room. The room is nearly divide into fourths by the same lockers, there are laundry carts scattered throughout the room and there is a huge space in the middle with the Patriots Logo.

Julian Edelman has appeared!!

Welcome to the receiver corner! Here, take these new glvoes as a welcoming present.

This is your locker. You'll find most of your things in here, otherwise, try checking the equipment rooms. One more thing... We really need you today. Anything to win ... anything.

You can also see Gloves, Jersey and Game pants here.

>take gloves
Taken.

>wear gloves
You put on Gloves.

>wear gloves
You're already wearing that!

* * *

>n
Hallway
You walk into a hallway. Straight ahead is a graphic of the phrase DO YOUR JOB! plastered on the wall. The hallway continues to the East and West.

>w
West Hallway
The West Hall, very similar ot the east, is also covered in photos of Patriots and newspaper headlines. To the north is the locker room.

You can see Newspapers here.

>n
Southwest Locker Room
Huge defensive linemen crowd this section of the locker room. Definetly not your side of the locker room. Exits are to the south, west, north and east.

It's Dont'a Hightower!

Hey rook, don't be late for warmups. Get to the receiver corner, Juls wanted to talk to you before you head out.

>n
Northwest Locker Room
The north west corner of the locker room aka the Reciever Corner. Exits are to the south, west, east, and north.

Julian Edelman has appeared!!

Welcome to the receiver corner! Here, take these new gloves as a welcoming present.

This is your locker. You'll find most of your things in here, otherwise, try checking the equipment rooms. One more thing... We really need you today. Anything to win ... anything.

You can also see Gloves, Jersey and Game pants here.

>take all
There are none at all available!

>take gloves
Taken.

* * *

>n
Northwest Locker Room
The north west corner of the locker room aka the Reciever Corner. Exits are to the south, west, east, and north.

Julian Edelman has appeared!!

Welcome to the receiver corner! Here, take these new gloves as a welcoming present.

This is your locker. You'll find most of your things in here, otherwise, try checking the equipment rooms. One more thing... We really need you today. Anything to win ... anything.

You can also see Gloves, Jersey and Game pants here.

>w
Quarterback Room
A smaller office like room. At the front of the room is a large screen and a projector on the ceiling. On the table is the missing screwdriver. Exits are to the east and south.

You can see screen and Screwdriver here.

* * *

>n
Southwest Locker Room
Huge defensive linemen crowd this section of the locker room. Definetly not your side of the locker room. Exits are to the south, west, north and east.

It's Dont'a Hightower!

Hey rook, don't be late for warmups. Get to the receiver corner, Juls wanted to talk to you before you head out.

>x lockers
You can't see any such thing.

* * *

Road To Foxborough
An Interactive Fiction by Avery Serna
Release 1 / Serial number 170301 / Inform 7 build 6M62 (I6/v6.33 lib 6/12N) SD

Outside
Congratulations! You were the #1 overall pick in the draft to the New England Patriots! You survived training camp and were signed to a 5 year $100,000,000 contract. You are the future of this franchise.

Just ahead of you is the Gillette Stadium. The new season starts today so get to the locker room and prepare yourself for tonight's game against the Falcons. Good Luck!.

>x door
You see nothing special about the door.

>enter door
(first opening the door)
You can't, since the door leads nowhere.